Run,Filename,File Size (B),Transfer Time (s),Throughput (B/s),Total Bytes,Bytes Sent,Bytes Received,Num Peers,Overhead Ratio
1,A_10kB,10240,4.55579948425293,6743.053575159165,10240,10240,0,1,0.3333333333333333
2,A_10kB,10240,5.021164894104004,6118.102202951412,954,494,460,1,0.0310546875
3,A_10kB,10240,5.016193866729736,6124.165216929232,1187,583,604,1,0.03863932291666667
4,A_10kB,10240,5.0202553272247314,6119.210677075752,10240,10240,0,1,0.3333333333333333
5,A_10kB,10240,5.102825880050659,6020.193657812017,716,510,206,1,0.023307291666666667
6,A_10kB,10240,5.01711630821228,6123.03923465276,10240,10240,0,1,0.3333333333333333
7,A_10kB,10240,5.021173715591431,6118.091454316786,1844,1313,531,1,0.06002604166666667
8,A_10kB,10240,5.016650915145874,6123.6072670020985,10240,10240,0,1,0.3333333333333333
9,A_10kB,10240,5.016131401062012,6124.241480894218,2189,1243,946,1,0.07125651041666667
10,A_10kB,10240,5.258037805557251,5842.48366710712,2207,1600,607,1,0.07184244791666666
11,A_10kB,10240,5.0137457847595215,6127.155487895055,6208,3503,2705,1,0.20208333333333334
12,A_10kB,10240,5.016752243041992,6123.483582950951,6069,3713,2356,1,0.19755859375
13,A_10kB,10240,5.022584915161133,6116.372449427159,2960,1918,1042,1,0.09635416666666667
14,A_10kB,10240,5.019254684448242,6120.430607991153,3381,2549,832,1,0.11005859375
15,A_10kB,10240,2.510828733444214,12235.004160502827,1158,1029,129,1,0.0376953125
16,A_10kB,10240,5.169241666793823,5942.844614392697,2704,1733,971,1,0.08802083333333334
17,A_10kB,10240,5.011144399642944,6130.336216651204,937,812,125,1,0.030501302083333334
18,A_10kB,10240,5.009867906570435,6131.89820029202,1127,734,393,1,0.03668619791666667
19,A_10kB,10240,5.018818378448486,6120.962681557877,2005,1325,680,1,0.06526692708333333
20,A_10kB,10240,5.017979383468628,6121.986092889268,1165,836,329,1,0.037923177083333336
21,A_10kB,10240,5.154427766799927,5959.92443581612,2906,1398,1508,1,0.09459635416666666
22,A_10kB,10240,5.014261960983276,6126.524748614437,2363,1994,369,1,0.07692057291666667
23,A_10kB,10240,5.026490211486816,6111.620376738611,6691,3805,2886,1,0.21780598958333333
24,A_10kB,10240,5.018826246261597,6120.9530859695715,3174,2407,767,1,0.1033203125
25,A_10kB,10240,5.013731479644775,6127.172969816988,6401,3593,2808,1,0.20836588541666667
26,A_10kB,10240,5.087394714355469,6038.454203939624,3687,2315,1372,1,0.12001953125
27,A_10kB,10240,5.012276887893677,6128.951110861226,8863,4857,4006,1,0.28850911458333334
28,A_10kB,10240,5.066640138626099,6063.189640369885,8043,5086,2957,1,0.26181640625
29,A_10kB,10240,5.020142078399658,6119.348719666725,10255,6206,4049,1,0.3338216145833333
30,A_10kB,10240,5.016026020050049,6124.37014425485,3761,2674,1087,1,0.12242838541666666
31,A_10kB,10240,5.119924068450928,6000.0889836037295,5968,3932,2036,1,0.19427083333333334
32,A_10kB,10240,5.010969400405884,6130.550307793081,5868,3181,2687,1,0.191015625
33,A_10kB,10240,5.013900518417358,6126.966398148002,7379,4118,3261,1,0.24020182291666667
34,A_10kB,10240,5.016050815582275,6124.339870036573,4724,3077,1647,1,0.15377604166666667
35,A_10kB,10240,5.015209436416626,6125.367323034366,7087,3219,3868,1,0.23069661458333332
36,A_10kB,10240,5.155769109725952,5958.373881027593,9043,4745,4298,1,0.29436848958333334
37,A_10kB,10240,5.025933504104614,6112.297342356674,4840,2580,2260,1,0.15755208333333334
38,A_10kB,10240,5.020242929458618,6119.22578880318,6852,3400,3452,1,0.223046875
39,A_10kB,10240,5.01798939704895,6121.973876243392,7331,3038,4293,1,0.23863932291666667
40,A_10kB,10240,5.011806011199951,6129.526947242091,7017,4143,2874,1,0.22841796875
41,A_10kB,10240,5.034059524536133,6102.430821540736,1651,1035,616,1,0.05374348958333333
42,A_10kB,10240,5.016205787658691,6124.150662953269,2633,1623,1010,1,0.08570963541666667
43,A_10kB,10240,5.048779249191284,6084.639173899462,1863,1221,642,1,0.06064453125
44,A_10kB,10240,5.016254901885986,6124.090701301891,3594,2325,1269,1,0.1169921875
45,A_10kB,10240,5.029263496398926,6108.2502481717775,3822,2434,1388,1,0.1244140625
46,A_10kB,10240,5.024327754974365,6114.250800932619,2686,1793,893,1,0.08743489583333333
47,A_10kB,10240,5.171935081481934,5939.7497292633625,745,558,187,1,0.024251302083333332
48,A_10kB,10240,5.020962715148926,6118.348560389343,865,436,429,1,0.028157552083333332
49,A_10kB,10240,5.016268253326416,6124.074401250129,845,545,300,1,0.027506510416666668
50,A_10kB,10240,5.024155616760254,6114.460288116891,472,347,125,1,0.015364583333333333
51,A_10kB,10240,5.016665935516357,6123.588932344972,836,375,461,1,0.027213541666666667
52,A_10kB,10240,3.663616895675659,8385.156219871207,10240,10240,0,1,0.3333333333333333
53,A_10kB,10240,5.02849006652832,6109.189755486412,6076,3170,2906,1,0.19778645833333333
54,A_10kB,10240,5.026602029800415,6111.484421856998,4777,2816,1961,1,0.15550130208333332
55,A_10kB,10240,5.0270843505859375,6110.898058915482,5885,3430,2455,1,0.19156901041666666
56,A_10kB,10240,5.041426420211792,6093.513509755726,4172,2454,1718,1,0.13580729166666666
57,A_10kB,10240,5.019444942474365,6120.198617988305,4517,2614,1903,1,0.14703776041666666
58,A_10kB,10240,5.040591478347778,6094.522861445916,2598,2092,506,1,0.0845703125
59,A_10kB,10240,5.023080348968506,6115.769182610901,3530,2330,1200,1,0.11490885416666667
60,A_10kB,10240,5.02720832824707,6110.747356020495,3180,1869,1311,1,0.103515625
61,A_10kB,10240,5.035093545913696,6101.177608692348,3639,2232,1407,1,0.11845703125
62,A_10kB,10240,5.040262222290039,6094.920987274029,2609,1726,883,1,0.08492838541666667
63,A_10kB,10240,5.184731721878052,5925.089599211196,1102,727,375,1,0.035872395833333334
64,A_10kB,10240,5.02530574798584,6113.060884367619,2633,1774,859,1,0.08570963541666667
65,A_10kB,10240,3.522873878479004,8720.153221398696,3101,1697,1404,1,0.10094401041666666
66,A_10kB,10240,5.016714334487915,6123.529854752188,2904,1201,1703,1,0.09453125
67,A_10kB,10240,5.017317533493042,6122.79366313354,4733,2685,2048,1,0.15406901041666668
68,A_10kB,10240,5.014492750167847,6126.2427787878905,5395,2383,3012,1,0.17561848958333334
69,A_10kB,10240,5.044640064239502,6089.631690032409,3398,1636,1762,1,0.11061197916666667
70,A_10kB,10240,5.010472297668457,6131.158536550548,10240,10240,0,1,0.3333333333333333
71,A_10kB,10240,5.172286510467529,5939.346155289294,3399,2259,1140,1,0.11064453125
72,A_10kB,10240,5.015368938446045,6125.172520113394,876,733,143,1,0.028515625
73,A_10kB,10240,5.016266822814941,6124.076147680095,7082,4227,2855,1,0.23053385416666666
74,A_10kB,10240,5.014391899108887,6126.365991748528,3440,2021,1419,1,0.11197916666666667
75,A_10kB,10240,5.01782488822937,6122.174584462254,4091,2465,1626,1,0.13317057291666667
76,A_10kB,10240,5.158165693283081,5955.605505267758,2830,1693,1137,1,0.09212239583333333
77,A_10kB,10240,5.0118443965911865,6129.480001592678,4089,2844,1245,1,0.13310546875
78,A_10kB,10240,5.018022060394287,6121.934027046944,3177,1763,1414,1,0.10341796875
79,A_10kB,10240,5.012894868850708,6128.1955444326095,6416,3750,2666,1,0.20885416666666667
80,A_10kB,10240,5.012683153152466,6128.454374915011,5592,3697,1895,1,0.18203125
81,A_10kB,10240,5.079552173614502,6047.777235082575,5209,3490,1719,1,0.16956380208333333
82,A_10kB,10240,5.0340211391448975,6102.477353763803,6894,4292,2602,1,0.2244140625
83,A_10kB,10240,5.063652038574219,6066.7675752558,6289,3503,2786,1,0.20472005208333333
84,A_10kB,10240,5.0382843017578125,6097.313720323815,7260,4241,3019,1,0.236328125
85,A_10kB,10240,5.028944492340088,6108.637716481387,9962,5280,4682,1,0.32428385416666666
86,A_10kB,10240,5.1564671993255615,5957.5672282019,9194,5436,3758,1,0.29928385416666664
87,A_10kB,10240,5.04733681678772,6086.3780474930045,8639,5908,2731,1,0.28121744791666664
88,A_10kB,10240,5.026719093322754,6111.342096041717,8870,5388,3482,1,0.2887369791666667
89,A_10kB,10240,5.036792278289795,6099.119896687648,7423,4893,2530,1,0.24163411458333334
90,A_10kB,10240,5.039172887802124,6096.2385462823,3679,2879,800,1,0.11975911458333334
91,A_10kB,10240,5.0383405685424805,6097.245627221832,2632,1756,876,1,0.08567708333333333
92,A_10kB,10240,5.057794094085693,6073.794114300201,1422,789,633,1,0.0462890625
93,A_10kB,10240,5.0345237255096436,6101.868155739046,5350,3206,2144,1,0.17415364583333334
94,A_10kB,10240,5.012201309204102,6129.0435289555635,5669,3661,2008,1,0.18453776041666667
95,A_10kB,10240,5.010261058807373,6131.41703384863,7439,4209,3230,1,0.24215494791666667
96,A_10kB,10240,5.01541543006897,6125.115741325051,5048,2713,2335,1,0.16432291666666668
97,A_10kB,10240,5.137819290161133,5979.190443468586,5010,2574,2436,1,0.1630859375
98,A_10kB,10240,5.030254125595093,6107.047324645003,3411,2179,1232,1,0.11103515625
99,A_10kB,10240,5.01990270614624,6119.640518607506,3445,2302,1143,1,0.11214192708333333
100,A_10kB,10240,5.011787176132202,6129.549982947971,4847,3483,1364,1,0.15777994791666666
101,A_10kB,10240,5.027997255325317,6109.78853806323,4311,2866,1445,1,0.14033203125
102,A_10kB,10240,5.144882440567017,5970.981913556484,3089,2036,1053,1,0.10055338541666667
103,A_10kB,10240,5.033685922622681,6102.883746070928,5044,3141,1903,1,0.16419270833333333
104,A_10kB,10240,5.023967027664185,6114.6898120234655,3553,2617,936,1,0.11565755208333334
105,A_10kB,10240,5.026625633239746,6111.455724264955,4542,3248,1294,1,0.1478515625
106,A_10kB,10240,5.01590895652771,6124.513077539207,6445,3778,2667,1,0.20979817708333334
107,A_10kB,10240,5.139874458312988,5976.799676559208,7393,4231,3162,1,0.24065755208333334
108,A_10kB,10240,5.016573905944824,6123.701270222626,8348,4502,3846,1,0.27174479166666665
109,A_10kB,10240,5.011260986328125,6130.193594748156,7843,4709,3134,1,0.25530598958333334
110,A_10kB,10240,5.013872385025024,6127.000777233918,8789,4650,4139,1,0.28610026041666664
111,A_10kB,10240,5.011600494384766,6129.778308231102,5298,2977,2321,1,0.1724609375
112,A_10kB,10240,5.140815258026123,5975.7058867342585,6861,4246,2615,1,0.22333984375
113,A_10kB,10240,5.010692834854126,6130.88868395868,8486,4463,4023,1,0.2762369791666667
114,A_10kB,10240,5.019576072692871,6120.038735366655,7900,4314,3586,1,0.2571614583333333
115,A_10kB,10240,5.019975900650024,6119.551290280526,7202,4047,3155,1,0.23444010416666666
116,A_10kB,10240,5.062980651855469,6067.572071155715,8671,5352,3319,1,0.28225911458333336
117,A_10kB,10240,5.043824672698975,6090.616148154409,7596,4494,3102,1,0.247265625
118,A_10kB,10240,5.013424873352051,6127.547689661528,8341,4448,3893,1,0.27151692708333336
119,A_10kB,10240,5.012537002563477,6128.6330623174235,13195,7905,5290,1,0.4295247395833333
120,A_10kB,10240,5.012903213500977,6128.185343228553,14825,9746,5079,1,0.4825846354166667
121,A_10kB,10240,5.019804954528809,6119.759687532238,14197,8889,5308,1,0.46214192708333335
122,A_10kB,10240,5.012944936752319,6128.134337717705,13031,7699,5332,1,0.4241861979166667
123,A_10kB,10240,5.441159009933472,5645.855955306039,10294,5839,4455,1,0.3350911458333333
124,A_10kB,10240,5.011801719665527,6129.532195868706,6842,3957,2885,1,0.22272135416666666
125,A_10kB,10240,5.107469320297241,6014.720417001385,2672,2211,461,1,0.08697916666666666
126,A_10kB,10240,5.110686779022217,6010.9338193246485,10240,10240,0,1,0.3333333333333333
127,A_10kB,10240,5.125723600387573,5993.300145500853,10240,10240,0,1,0.3333333333333333
128,A_10kB,10240,5.2685229778289795,5830.856224652722,10240,10240,0,1,0.3333333333333333
129,A_10kB,10240,5.097790241241455,6026.1404542449,10240,10240,0,1,0.3333333333333333
130,A_10kB,10240,5.215929269790649,5889.650417217602,10240,10240,0,1,0.3333333333333333
131,A_10kB,10240,5.142382383346558,5973.884808622118,10240,10240,0,1,0.3333333333333333
132,A_10kB,10240,5.113674163818359,6007.422259587518,10240,10240,0,1,0.3333333333333333
133,A_10kB,10240,5.215987205505371,5889.584998900236,10240,10240,0,1,0.3333333333333333
134,A_10kB,10240,5.126734256744385,5992.118659083381,10240,10240,0,1,0.3333333333333333
135,A_10kB,10240,5.116936683654785,6003.591972933728,10240,10240,0,1,0.3333333333333333
136,A_10kB,10240,5.1306798458099365,5987.51060740772,10240,10240,0,1,0.3333333333333333
137,A_10kB,10240,5.133660793304443,5984.033857489462,10240,10240,0,1,0.3333333333333333
138,A_10kB,10240,5.243362665176392,5858.835629285343,10240,10240,0,1,0.3333333333333333
139,A_10kB,10240,5.120584726333618,5999.314852074673,10240,10240,0,1,0.3333333333333333
140,A_10kB,10240,5.135663032531738,5981.700864212638,10240,10240,0,1,0.3333333333333333
141,A_10kB,10240,5.133462429046631,5984.265089031774,10240,10240,0,1,0.3333333333333333
142,A_10kB,10240,5.091211318969727,6033.9275027807325,10240,10240,0,1,0.3333333333333333
143,A_10kB,10240,5.180596113204956,5929.8195282386505,10240,10240,0,1,0.3333333333333333
144,A_10kB,10240,5.065375566482544,6064.703317020248,10240,10240,0,1,0.3333333333333333
145,A_10kB,10240,5.021781921386719,6117.350470590916,10240,10240,0,1,0.3333333333333333
146,A_10kB,10240,5.065127849578857,6064.999919509283,10240,10240,0,1,0.3333333333333333
147,A_10kB,10240,5.110893249511719,6010.690988886318,10240,10240,0,1,0.3333333333333333
148,A_10kB,10240,5.213315010070801,5892.603830893925,10240,10240,0,1,0.3333333333333333
149,A_10kB,10240,5.067740201950073,6061.873493076639,10240,10240,0,1,0.3333333333333333
150,A_10kB,10240,5.095209360122681,6029.192880753449,10240,10240,0,1,0.3333333333333333
151,A_10kB,10240,5.078003406524658,6049.621778616432,10240,10240,0,1,0.3333333333333333
152,A_10kB,10240,5.0884339809417725,6037.220904321198,10240,10240,0,1,0.3333333333333333
153,A_10kB,10240,5.117962837219238,6002.38825037878,10240,10240,0,1,0.3333333333333333
154,A_10kB,10240,5.068496227264404,6060.9692939596725,10240,10240,0,1,0.3333333333333333
155,A_10kB,10240,5.05267858505249,6079.943436513064,10240,10240,0,1,0.3333333333333333
156,A_10kB,10240,5.1055006980896,6017.039623850204,10240,10240,0,1,0.3333333333333333
157,A_10kB,10240,5.085500717163086,6040.703110378668,10240,10240,0,1,0.3333333333333333
158,A_10kB,10240,5.105561017990112,6016.968535241095,10240,10240,0,1,0.3333333333333333
159,A_10kB,10240,5.170909643173218,5940.927635538444,10240,10240,0,1,0.3333333333333333
160,A_10kB,10240,5.059303522109985,6071.982016051927,10240,10240,0,1,0.3333333333333333
161,A_10kB,10240,5.057270288467407,6074.423206142224,10240,10240,0,1,0.3333333333333333
162,A_10kB,10240,5.025734186172485,6112.539752802931,10240,10240,0,1,0.3333333333333333
163,A_10kB,10240,5.067648887634277,6061.982722394363,10240,10240,0,1,0.3333333333333333
164,A_10kB,10240,5.212952136993408,5893.014014457821,10240,10240,0,1,0.3333333333333333
165,A_10kB,10240,5.10603666305542,6016.4080337052155,10240,10240,0,1,0.3333333333333333
166,A_10kB,10240,5.042940616607666,6091.683867708327,10240,10240,0,1,0.3333333333333333
167,A_10kB,10240,5.018218040466309,6121.694942762073,10240,10240,0,1,0.3333333333333333
168,A_10kB,10240,5.042634725570679,6092.053395067872,10240,10240,0,1,0.3333333333333333
169,A_10kB,10240,5.051371812820435,6081.51629662903,10240,10240,0,1,0.3333333333333333
170,A_10kB,10240,5.022799015045166,6116.11173530577,10240,10240,0,1,0.3333333333333333
171,A_10kB,10240,5.0338335037231445,6102.704822731771,10240,10240,0,1,0.3333333333333333
172,A_10kB,10240,5.086660861968994,6039.3253715185965,10240,10240,0,1,0.3333333333333333
173,A_10kB,10240,5.01251482963562,6128.660172409537,10240,10240,0,1,0.3333333333333333
174,A_10kB,10240,5.074266672134399,6054.076773043972,10240,10240,0,1,0.3333333333333333
175,A_10kB,10240,5.0547685623168945,6077.429583822377,10240,10240,0,1,0.3333333333333333
176,A_10kB,10240,5.197535514831543,5910.493523774539,10240,10240,0,1,0.3333333333333333
177,A_10kB,10240,5.041269302368164,6093.703422185581,10240,10240,0,1,0.3333333333333333
178,A_10kB,10240,5.014938592910767,6125.698137844899,10240,10240,0,1,0.3333333333333333
179,A_10kB,10240,5.113641023635864,6007.461192134619,10240,10240,0,1,0.3333333333333333
180,A_10kB,10240,5.099456548690796,6024.171341922086,10240,10240,0,1,0.3333333333333333
181,A_10kB,10240,5.149070978164673,5966.124788388485,10240,10240,0,1,0.3333333333333333
182,A_10kB,10240,5.13736629486084,5979.71766792855,10240,10240,0,1,0.3333333333333333
183,A_10kB,10240,5.088808059692383,6036.777107654757,10240,10240,0,1,0.3333333333333333
184,A_10kB,10240,5.1060144901275635,6016.434160027721,10240,10240,0,1,0.3333333333333333
185,A_10kB,10240,5.061568021774292,6069.265466323092,10240,10240,0,1,0.3333333333333333
186,A_10kB,10240,5.109027147293091,6012.886429126989,10240,10240,0,1,0.3333333333333333
187,A_10kB,10240,5.0147926807403564,6125.876373310944,10240,10240,0,1,0.3333333333333333
188,A_10kB,10240,5.017554044723511,6122.50505449071,10240,10240,0,1,0.3333333333333333
189,A_10kB,10240,5.021549224853516,6117.633946104777,10240,10240,0,1,0.3333333333333333
190,A_10kB,10240,5.088273048400879,6037.411850304407,10240,10240,0,1,0.3333333333333333
191,A_10kB,10240,5.035298824310303,6100.92887669041,10240,10240,0,1,0.3333333333333333
192,A_10kB,10240,5.038625001907349,6096.9014340958265,10240,10240,0,1,0.3333333333333333
193,A_10kB,10240,5.033186674118042,6103.489099255994,10240,10240,0,1,0.3333333333333333
194,A_10kB,10240,5.023800849914551,6114.892074299186,10240,10240,0,1,0.3333333333333333
195,A_10kB,10240,5.213742733001709,5892.120415829104,10240,10240,0,1,0.3333333333333333
196,A_10kB,10240,5.15491509437561,5959.36100548344,10240,10240,0,1,0.3333333333333333
197,A_10kB,10240,5.153554677963257,5960.934135686884,10240,10240,0,1,0.3333333333333333
198,A_10kB,10240,5.028626441955566,6109.0240753801945,10240,10240,0,1,0.3333333333333333
199,A_10kB,10240,5.024195194244385,6114.412122202617,10240,10240,0,1,0.3333333333333333
200,A_10kB,10240,5.104978084564209,6017.655608138118,10240,10240,0,1,0.3333333333333333
201,A_10kB,10240,5.015772342681885,6124.67988999164,10240,10240,0,1,0.3333333333333333
202,A_10kB,10240,5.033693790435791,6102.874207082116,10240,10240,0,1,0.3333333333333333
203,A_10kB,10240,5.027802228927612,6110.025534268542,10240,10240,0,1,0.3333333333333333
204,A_10kB,10240,5.032586097717285,6104.217474577174,10240,10240,0,1,0.3333333333333333
205,A_10kB,10240,5.108676195144653,6013.299498057178,10240,10240,0,1,0.3333333333333333
206,A_10kB,10240,5.02247953414917,6116.500782357912,10240,10240,0,1,0.3333333333333333
207,A_10kB,10240,5.017791271209717,6122.215600369892,10240,10240,0,1,0.3333333333333333
208,A_10kB,10240,5.020474195480347,6118.943909253732,10240,10240,0,1,0.3333333333333333
209,A_10kB,10240,5.015019416809082,6125.5994138396145,10240,10240,0,1,0.3333333333333333
210,A_10kB,10240,5.013228416442871,6127.787814184085,10240,10240,0,1,0.3333333333333333
211,A_10kB,10240,5.020108461380005,6119.389697718844,10240,10240,0,1,0.3333333333333333
212,A_10kB,10240,5.027767658233643,6110.067546516771,10240,10240,0,1,0.3333333333333333
213,A_10kB,10240,5.025383710861206,6112.966047469334,10240,10240,0,1,0.3333333333333333
214,A_10kB,10240,5.024200439453125,6114.405738825144,10240,10240,0,1,0.3333333333333333
215,A_10kB,10240,5.076411008834839,6051.519458636387,10240,10240,0,1,0.3333333333333333
216,A_10kB,10240,5.026250839233398,6111.9114390807845,10240,10240,0,1,0.3333333333333333
217,A_10kB,10240,5.041677236557007,6093.210366036617,10240,10240,0,1,0.3333333333333333
218,A_10kB,10240,5.026352643966675,6111.787647226543,10240,10240,0,1,0.3333333333333333
219,A_10kB,10240,5.02316951751709,6115.660618832676,10240,10240,0,1,0.3333333333333333
220,A_10kB,10240,5.03648042678833,6099.4975452708295,10240,10240,0,1,0.3333333333333333
221,A_10kB,10240,5.021531343460083,6117.655730658529,10240,10240,0,1,0.3333333333333333
222,A_10kB,10240,5.0230443477630615,6115.813015602917,10240,10240,0,1,0.3333333333333333
223,A_10kB,10240,5.034226179122925,6102.228804775735,10240,10240,0,1,0.3333333333333333
224,A_10kB,10240,5.020398378372192,6119.036316389022,10240,10240,0,1,0.3333333333333333
225,A_10kB,10240,5.020825386047363,6118.515908832326,10240,10240,0,1,0.3333333333333333
226,A_10kB,10240,5.044166088104248,6090.2039035644675,10240,10240,0,1,0.3333333333333333
227,A_10kB,10240,5.068850755691528,6060.54537421648,10240,10240,0,1,0.3333333333333333
228,A_10kB,10240,5.09714937210083,6026.898126263565,10240,10240,0,1,0.3333333333333333
229,A_10kB,10240,5.102844715118408,6020.171436725203,10240,10240,0,1,0.3333333333333333
230,A_10kB,10240,5.026782512664795,6111.264993582293,10240,10240,0,1,0.3333333333333333
231,A_10kB,10240,5.179866075515747,5930.655262538092,10240,10240,0,1,0.3333333333333333
232,A_10kB,10240,5.053232431411743,6079.277060172279,10240,10240,0,1,0.3333333333333333
233,A_10kB,10240,5.03037428855896,6106.901442675808,10240,10240,0,1,0.3333333333333333
234,A_10kB,10240,5.018468141555786,6121.38986110539,10240,10240,0,1,0.3333333333333333
235,A_10kB,10240,5.039144277572632,6096.273158266844,10240,10240,0,1,0.3333333333333333
236,A_10kB,10240,5.067679405212402,6061.946217119161,10240,10240,0,1,0.3333333333333333
237,A_10kB,10240,5.018422842025757,6121.445116729032,10240,10240,0,1,0.3333333333333333
238,A_10kB,10240,5.028918266296387,6108.669573312463,10240,10240,0,1,0.3333333333333333
239,A_10kB,10240,5.0190699100494385,6120.655928400369,10240,10240,0,1,0.3333333333333333
240,A_10kB,10240,5.020637273788452,6118.7451561939715,10240,10240,0,1,0.3333333333333333
241,A_10kB,10240,5.020901679992676,6118.422936344934,10240,10240,0,1,0.3333333333333333
242,A_10kB,10240,5.185751438140869,5923.924500903837,10240,10240,0,1,0.3333333333333333
243,A_10kB,10240,5.029611110687256,6107.828085301481,10240,10240,0,1,0.3333333333333333
244,A_10kB,10240,5.0311267375946045,6105.98810211792,10240,10240,0,1,0.3333333333333333
245,A_10kB,10240,5.040440559387207,6094.705341339209,10240,10240,0,1,0.3333333333333333
246,A_10kB,10240,5.0883214473724365,6037.354423797957,10240,10240,0,1,0.3333333333333333
247,A_10kB,10240,5.09850549697876,6025.295063073652,10240,10240,0,1,0.3333333333333333
248,A_10kB,10240,5.147748231887817,5967.657821667427,10240,10240,0,1,0.3333333333333333
249,A_10kB,10240,5.294229984283447,5802.5435410240925,10240,10240,0,1,0.3333333333333333
250,A_10kB,10240,5.118530511856079,6001.722550806936,10240,10240,0,1,0.3333333333333333
251,A_10kB,10240,5.096508026123047,6027.656552788546,10240,10240,0,1,0.3333333333333333
252,A_10kB,10240,5.095756530761719,6028.5454798618375,10240,10240,0,1,0.3333333333333333
253,A_10kB,10240,5.024596691131592,6113.923542206038,10240,10240,0,1,0.3333333333333333
254,A_10kB,10240,5.060410976409912,6070.653182756745,10240,10240,0,1,0.3333333333333333
255,A_10kB,10240,5.069108486175537,6060.237235754477,10240,10240,0,1,0.3333333333333333
256,A_10kB,10240,5.098659038543701,6025.113616692119,10240,10240,0,1,0.3333333333333333
257,A_10kB,10240,5.140995740890503,5975.496100037383,10240,10240,0,1,0.3333333333333333
258,A_10kB,10240,5.057234525680542,6074.466162090054,10240,10240,0,1,0.3333333333333333
259,A_10kB,10240,5.041881084442139,6092.964011942584,10240,10240,0,1,0.3333333333333333
260,A_10kB,10240,5.0686914920806885,6060.7358029181405,10240,10240,0,1,0.3333333333333333
261,A_10kB,10240,5.092601776123047,6032.280031011353,10240,10240,0,1,0.3333333333333333
262,A_10kB,10240,5.107156753540039,6015.088528212171,10240,10240,0,1,0.3333333333333333
263,A_10kB,10240,5.020983457565308,6118.323284597363,10240,10240,0,1,0.3333333333333333
264,A_10kB,10240,5.0452001094818115,6088.955707081998,10240,10240,0,1,0.3333333333333333
265,A_10kB,10240,5.037736415863037,6097.976841993473,10240,10240,0,1,0.3333333333333333
266,A_10kB,10240,5.033958435058594,6102.553367555254,10240,10240,0,1,0.3333333333333333
267,A_10kB,10240,5.0261781215667725,6111.999864904089,10240,10240,0,1,0.3333333333333333
268,A_10kB,10240,5.091362476348877,6033.748361603583,10240,10240,0,1,0.3333333333333333
269,A_10kB,10240,5.050718545913696,6082.302888339351,10240,10240,0,1,0.3333333333333333
270,A_10kB,10240,5.09686803817749,6027.230795440544,10240,10240,0,1,0.3333333333333333
271,A_10kB,10240,5.019468784332275,6120.169547799387,10240,10240,0,1,0.3333333333333333
272,A_10kB,10240,5.047484397888184,6086.2000906536605,10240,10240,0,1,0.3333333333333333
273,A_10kB,10240,5.090618371963501,6034.630324910999,10240,10240,0,1,0.3333333333333333
274,A_10kB,10240,5.088479518890381,6037.166875872374,10240,10240,0,1,0.3333333333333333
275,A_10kB,10240,5.181371688842773,5928.9319208947,10240,10240,0,1,0.3333333333333333
276,A_10kB,10240,5.10351300239563,6019.3831162142205,10240,10240,0,1,0.3333333333333333
277,A_10kB,10240,5.077570915222168,6050.137066112419,10240,10240,0,1,0.3333333333333333
278,A_10kB,10240,5.106022357940674,6016.424889371182,10240,10240,0,1,0.3333333333333333
279,A_10kB,10240,5.110830307006836,6010.765013638499,10240,10240,0,1,0.3333333333333333
280,A_10kB,10240,5.189788818359375,5919.316002093391,10240,10240,0,1,0.3333333333333333
281,A_10kB,10240,5.0773890018463135,6050.3538312367145,10240,10240,0,1,0.3333333333333333
282,A_10kB,10240,5.08864951133728,6036.965197064022,10240,10240,0,1,0.3333333333333333
283,A_10kB,10240,5.061326503753662,6069.555081502239,10240,10240,0,1,0.3333333333333333
284,A_10kB,10240,5.037754535675049,6097.954908770398,10240,10240,0,1,0.3333333333333333
285,A_10kB,10240,5.052752494812012,6079.854501391512,10240,10240,0,1,0.3333333333333333
286,A_10kB,10240,5.08017373085022,6047.0372919429055,10240,10240,0,1,0.3333333333333333
287,A_10kB,10240,5.026209354400635,6111.961884974705,10240,10240,0,1,0.3333333333333333
288,A_10kB,10240,5.041860103607178,6092.989366765949,10240,10240,0,1,0.3333333333333333
289,A_10kB,10240,5.019765138626099,6119.808228400107,10240,10240,0,1,0.3333333333333333
290,A_10kB,10240,5.017299652099609,6122.815484449783,10240,10240,0,1,0.3333333333333333
291,A_10kB,10240,5.074981212615967,6053.224379162769,10240,10240,0,1,0.3333333333333333
292,A_10kB,10240,5.043942451477051,6090.473928980705,10240,10240,0,1,0.3333333333333333
293,A_10kB,10240,5.047677278518677,6085.967526239175,10240,10240,0,1,0.3333333333333333
294,A_10kB,10240,5.074808359146118,6053.430558542099,10240,10240,0,1,0.3333333333333333
295,A_10kB,10240,5.0684449672698975,6061.03059190307,10240,10240,0,1,0.3333333333333333
296,A_10kB,10240,5.146209239959717,5969.442470675846,10240,10240,0,1,0.3333333333333333
297,A_10kB,10240,5.106813192367554,6015.493193663894,10240,10240,0,1,0.3333333333333333
298,A_10kB,10240,5.100496768951416,6022.942742950813,10240,10240,0,1,0.3333333333333333
299,A_10kB,10240,5.050916910171509,6082.064018542105,10240,10240,0,1,0.3333333333333333
300,A_10kB,10240,5.04819917678833,6085.338340303779,10240,10240,0,1,0.3333333333333333
301,A_10kB,10240,5.154188632965088,5960.200952584749,10240,10240,0,1,0.3333333333333333
302,A_10kB,10240,5.123478412628174,5995.926502643672,10240,10240,0,1,0.3333333333333333
303,A_10kB,10240,5.127911567687988,5990.742935890891,10240,10240,0,1,0.3333333333333333
304,A_10kB,10240,5.029848337173462,6107.540017252924,10240,10240,0,1,0.3333333333333333
305,A_10kB,10240,5.1477508544921875,5967.65478134828,10240,10240,0,1,0.3333333333333333
306,A_10kB,10240,5.1121132373809814,6009.256558592657,10240,10240,0,1,0.3333333333333333
307,A_10kB,10240,5.0738842487335205,6054.533074472076,10240,10240,0,1,0.3333333333333333
308,A_10kB,10240,5.034973382949829,6101.323217323969,10240,10240,0,1,0.3333333333333333
309,A_10kB,10240,5.06262993812561,6067.992402259957,10240,10240,0,1,0.3333333333333333
310,A_10kB,10240,5.074278116226196,6054.063119198292,10240,10240,0,1,0.3333333333333333
311,A_10kB,10240,5.090289831161499,6035.019815952273,10240,10240,0,1,0.3333333333333333
312,A_10kB,10240,5.038782835006714,6096.710456853628,10240,10240,0,1,0.3333333333333333
313,A_10kB,10240,5.040166139602661,6095.037177171663,10240,10240,0,1,0.3333333333333333
314,A_10kB,10240,5.027409791946411,6110.502479668849,10240,10240,0,1,0.3333333333333333
315,A_10kB,10240,5.032195329666138,6104.691489000314,10240,10240,0,1,0.3333333333333333
316,A_10kB,10240,5.0917816162109375,6033.251681925111,10240,10240,0,1,0.3333333333333333
317,A_10kB,10240,5.112884283065796,6008.350335982887,10240,10240,0,1,0.3333333333333333
318,A_10kB,10240,5.115308046340942,6005.503426518855,10240,10240,0,1,0.3333333333333333
319,A_10kB,10240,5.085246562957764,6041.005017096385,10240,10240,0,1,0.3333333333333333
320,A_10kB,10240,5.125489234924316,5993.574192035859,10240,10240,0,1,0.3333333333333333
321,A_10kB,10240,5.129192352294922,5989.247017857528,10240,10240,0,1,0.3333333333333333
322,A_10kB,10240,5.185948371887207,5923.699542890118,10240,10240,0,1,0.3333333333333333
323,A_10kB,10240,5.048155069351196,6085.3915099617225,10240,10240,0,1,0.3333333333333333
324,A_10kB,10240,5.019477367401123,6120.15908259898,10240,10240,0,1,0.3333333333333333
325,A_10kB,10240,5.031864881515503,6105.092390864779,10240,10240,0,1,0.3333333333333333
326,A_10kB,10240,5.032413959503174,6104.426274787784,10240,10240,0,1,0.3333333333333333
327,A_10kB,10240,5.100147247314453,6023.355505309381,10240,10240,0,1,0.3333333333333333
328,A_10kB,10240,5.08553671836853,6040.660347420548,10240,10240,0,1,0.3333333333333333
329,A_10kB,10240,5.083130598068237,6043.519718276498,10240,10240,0,1,0.3333333333333333
330,A_10kB,10240,5.0694780349731445,6059.795463767649,10240,10240,0,1,0.3333333333333333
331,A_10kB,10240,5.057955980300903,6073.599714913382,10240,10240,0,1,0.3333333333333333
332,A_10kB,10240,5.07498574256897,6053.2189760299625,10240,10240,0,1,0.3333333333333333
333,A_10kB,10240,5.038507699966431,6097.043376594358,10240,10240,0,1,0.3333333333333333
