Run,Filename,File Size (B),Transfer Time (s),Throughput (B/s),Total Bytes,Bytes Sent,Bytes Received,Num Peers
1,B_10kB,10240,4.52006983757019,2265.451722645201,10240,0,10240,1
2,B_10kB,10240,6.022500276565552,1700.2904989220788,10240,0,10240,1
3,B_10kB,10240,5.009460687637329,2044.1322207140847,10240,0,10240,1
4,B_10kB,10240,4.103789567947388,2495.25464950236,10240,0,10240,1
5,B_10kB,10240,3.009222984313965,3402.8717889560085,10240,0,10240,1
6,B_10kB,10240,3.008552312850952,3403.6303627695315,1121,739,382,1
7,B_10kB,10240,3.0150527954101562,3396.292103272105,1222,1036,186,1
8,B_10kB,10240,3.0076680183410645,3404.6310754895294,1033,643,390,1
9,B_10kB,10240,3.016545295715332,3394.6117151115827,1382,589,793,1
10,B_10kB,10240,3.0088248252868652,3403.3220923799395,913,737,176,1
11,B_10kB,10240,3.0083975791931152,3403.805424795774,10384,144,10240,1
12,B_10kB,10240,3.257086753845215,3143.9138020843247,1569,533,1036,1
13,B_10kB,10240,3.0076794624328613,3404.618121013812,1115,803,312,1
14,B_10kB,10240,3.006070852279663,3406.440001982809,1245,679,566,1
15,B_10kB,10240,3.0235729217529297,3386.7216915222652,1655,794,861,1
16,B_10kB,10240,3.0066938400268555,3405.7341867266864,1374,1113,261,1
17,B_10kB,10240,3.0101370811462402,3401.8384292653795,1257,968,289,1
18,B_10kB,10240,3.0108847618103027,3400.9936646805345,1689,759,930,1
19,B_10kB,10240,3.012319326400757,3399.3740007090064,1661,677,984,1
20,B_10kB,10240,2.6635489463806152,3844.494772252902,10240,0,10240,1
21,B_10kB,10240,3.0088915824890137,3403.2465840890395,10240,0,10240,1
22,B_10kB,10240,3.011200189590454,3400.6374054435473,10240,0,10240,1
23,B_10kB,10240,3.0121588706970215,3399.5550831057053,10240,0,10240,1
24,B_10kB,10240,3.0108962059020996,3400.980737870363,10240,0,10240,1
25,B_10kB,10240,3.0106358528137207,3401.274847115689,10240,0,10240,1
26,B_10kB,10240,3.009044885635376,3403.0731973736474,10240,0,10240,1
27,B_10kB,10240,3.0127456188201904,3398.8930017961643,10240,0,10240,1
28,B_10kB,10240,4.012880325317383,2551.7830510408025,1721,1052,669,1
29,B_10kB,10240,3.0099565982818604,3402.0424101281674,1830,1542,288,1
30,B_10kB,10240,3.0160071849823,3395.217375803465,10240,0,10240,1
31,B_10kB,10240,3.0107216835021973,3401.177882403399,1443,716,727,1
32,B_10kB,10240,3.010406970977783,3401.5334467133653,2126,1393,733,1
33,B_10kB,10240,3.0123724937438965,3399.31400292177,1212,826,386,1
34,B_10kB,10240,2.0082943439483643,5098.854174865556,1556,735,821,1
35,B_10kB,10240,1.0046577453613281,10192.525810187382,10240,0,10240,1
36,B_10kB,10240,1.00527024269104,10186.315644426335,848,451,397,1
37,B_10kB,10240,2.005598545074463,5105.707732561112,1588,652,936,1
38,B_10kB,10240,1.0056796073913574,10182.1692761193,10240,0,10240,1
39,B_10kB,10240,1.0036075115203857,10203.191867792233,786,652,134,1
40,B_10kB,10240,1.0029926300048828,10209.446902865227,1592,779,813,1
41,B_10kB,10240,1.004556655883789,10193.551493609935,10240,0,10240,1
42,B_10kB,10240,1.0038948059082031,10200.271920658142,1025,477,548,1
43,B_10kB,10240,1.011932611465454,10119.25091056281,1841,537,1304,1
44,B_10kB,10240,1.0056142807006836,10182.830729954489,1045,663,382,1
45,B_10kB,10240,1.0026955604553223,10212.471665228111,1627,1092,535,1
46,B_10kB,10240,1.003037691116333,10208.98824709505,1815,826,989,1
47,B_10kB,10240,1.0066075325012207,10172.78300566222,655,587,68,1
48,B_10kB,10240,1.003687858581543,10202.375083496208,1374,393,981,1
49,B_10kB,10240,1.005053997039795,10188.507314194134,1625,1312,313,1
50,B_10kB,10240,1.0034761428833008,10204.527603991937,473,375,98,1
51,B_10kB,10240,1.0036306381225586,10202.956756237985,1245,700,545,1
52,B_10kB,10240,0.08855652809143066,115632.35619882993,1158,901,257,1
53,B_10kB,10240,2.0081474781036377,5099.227079512099,2226,1573,653,1
54,B_10kB,10240,1.0030715465545654,10208.643675691144,1911,1133,778,1
55,B_10kB,10240,1.0031487941741943,10207.85755759165,1396,1011,385,1
56,B_10kB,10240,1.0034806728363037,10204.481538301072,2076,1052,1024,1
57,B_10kB,10240,1.0024330615997314,10215.145920724632,1288,448,840,1
58,B_10kB,10240,1.0080585479736328,10158.140140356056,1182,843,339,1
59,B_10kB,10240,1.005007266998291,10188.981051434937,1361,855,506,1
60,B_10kB,10240,1.0040006637573242,10199.196444430936,2021,755,1266,1
61,B_10kB,10240,1.0052204132080078,10186.82058725867,809,704,105,1
62,B_10kB,10240,1.004702091217041,10192.075929289473,835,533,302,1
63,B_10kB,10240,1.0038909912109375,10200.310680792205,2287,1101,1186,1
64,B_10kB,10240,1.0034770965576172,10204.517905917193,1409,807,602,1
65,B_10kB,10240,1.0031628608703613,10207.714419486781,1398,1018,380,1
66,B_10kB,10240,1.0029923915863037,10209.449329724937,1857,771,1086,1
67,B_10kB,10240,1.0027570724487305,10211.845202940272,1504,972,532,1
68,B_10kB,10240,0.6406006813049316,15984.99704861486,10240,0,10240,1
69,B_10kB,10240,1.0046095848083496,10193.014435506799,10240,0,10240,1
70,B_10kB,10240,1.0038855075836182,10200.366399000997,10240,0,10240,1
71,B_10kB,10240,1.0037219524383545,10202.028535017927,314,294,20,1
72,B_10kB,10240,1.0076611042022705,10162.146734944825,10240,0,10240,1
73,B_10kB,10240,1.0036938190460205,10202.314496399707,10240,0,10240,1
74,B_10kB,10240,1.0033283233642578,10206.031028471598,314,294,20,1
75,B_10kB,10240,1.0039713382720947,10199.494357701247,10240,0,10240,1
76,B_10kB,10240,1.00459623336792,10193.149904285712,10240,0,10240,1
77,B_10kB,10240,1.004324197769165,10195.910864983034,314,294,20,1
78,B_10kB,10240,1.0075180530548096,10163.589594203468,10240,0,10240,1
79,B_10kB,10240,1.0035045146942139,10204.239094151275,10240,0,10240,1
80,B_10kB,10240,1.004655361175537,10192.54999845746,10240,0,10240,1
81,B_10kB,10240,1.0065484046936035,10173.380586815483,10240,0,10240,1
82,B_10kB,10240,1.0032768249511719,10206.5549062178,10240,0,10240,1
83,B_10kB,10240,1.004239559173584,10196.77018940259,10240,0,10240,1
84,B_10kB,10240,2.0105597972869873,5093.108901221276,10240,0,10240,1
85,B_10kB,10240,1.0040779113769531,10198.411780573148,928,756,172,1
86,B_10kB,10240,1.0035722255706787,10203.550615579314,2259,1004,1255,1
87,B_10kB,10240,1.0046088695526123,10193.02169267153,1074,479,595,1
88,B_10kB,10240,1.0044481754302979,10194.652397684195,769,310,459,1
89,B_10kB,10240,1.004044532775879,10198.750818043402,1596,528,1068,1
90,B_10kB,10240,1.00319242477417,10207.413599943342,1259,711,548,1
91,B_10kB,10240,1.0046286582946777,10192.820914925964,1267,684,583,1
92,B_10kB,10240,1.003554344177246,10203.732423075862,1444,746,698,1
93,B_10kB,10240,1.0040273666381836,10198.925188948697,1315,801,514,1
94,B_10kB,10240,1.003361463546753,10205.693931878672,1489,1052,437,1
95,B_10kB,10240,1.003629446029663,10202.9688751254,1854,853,1001,1
96,B_10kB,10240,1.0032932758331299,10206.387550536261,595,477,118,1
97,B_10kB,10240,1.0039355754852295,10199.857690121926,713,459,254,1
98,B_10kB,10240,1.0039660930633545,10199.54764483646,1832,994,838,1
99,B_10kB,10240,0.15143418312072754,67620.13561915798,1119,824,295,1
100,B_10kB,10240,2.005167245864868,5106.805939064343,1850,1001,849,1
101,B_10kB,10240,1.003502607345581,10204.258489259313,1421,652,769,1
102,B_10kB,10240,1.0037200450897217,10202.047921723686,1019,760,259,1
103,B_10kB,10240,1.0086784362792969,10151.89740525454,1810,753,1057,1
104,B_10kB,10240,1.0054535865783691,10184.458175585663,1185,530,655,1
105,B_10kB,10240,1.0087757110595703,10150.91847249612,1328,724,604,1
106,B_10kB,10240,1.0063390731811523,10175.496781249081,1982,1085,897,1
107,B_10kB,10240,1.003206729888916,10207.26804846481,1194,354,840,1
108,B_10kB,10240,1.0046358108520508,10192.748346602597,1353,844,509,1
109,B_10kB,10240,1.0031077861785889,10208.274864468967,1987,713,1274,1
110,B_10kB,10240,1.003936767578125,10199.84557862419,1294,432,862,1
111,B_10kB,10240,1.006819486618042,10170.641446756938,884,640,244,1
112,B_10kB,10240,1.0073997974395752,10164.782667245081,1801,568,1233,1
113,B_10kB,10240,1.008540153503418,10153.28935038311,1944,932,1012,1
114,B_10kB,10240,1.0047483444213867,10191.60674098647,645,542,103,1
115,B_10kB,10240,0.6532866954803467,15674.58830991616,10240,0,10240,1
116,B_10kB,10240,1.0283429622650146,9957.767375045298,10240,0,10240,1
117,B_10kB,10240,1.024935007095337,9990.877401114567,10240,0,10240,1
118,B_10kB,10240,1.009885311126709,10139.765265597769,10240,0,10240,1
119,B_10kB,10240,1.0142595767974854,10096.034816188474,10240,0,10240,1
120,B_10kB,10240,1.0038375854492188,10200.853353600609,1246,779,467,1
121,B_10kB,10240,1.007784128189087,10160.906203593937,1373,649,724,1
122,B_10kB,10240,1.0041489601135254,10197.690190150974,1724,932,792,1
123,B_10kB,10240,1.0030386447906494,10208.978540539936,10240,0,10240,1
124,B_10kB,10240,1.0063397884368896,10175.489549017448,1264,783,481,1
125,B_10kB,10240,1.0043611526489258,10195.53571242056,1564,763,801,1
126,B_10kB,10240,1.0033705234527588,10205.601779851493,10240,0,10240,1
127,B_10kB,10240,1.003408432006836,10205.216214418097,10240,0,10240,1
128,B_10kB,10240,1.0075347423553467,10163.421239511423,10240,0,10240,1
129,B_10kB,10240,1.009547472000122,10143.158478434347,10240,0,10240,1
130,B_10kB,10240,1.0047266483306885,10191.826818780346,10240,0,10240,1
131,B_10kB,10240,2.0057361125946045,5105.357547136954,2095,893,1202,1
132,B_10kB,10240,1.00437593460083,10195.385659125426,1305,1038,267,1
133,B_10kB,10240,1.0199437141418457,10039.769702993533,1589,700,889,1
134,B_10kB,10240,1.0041544437408447,10197.634501175171,1353,855,498,1
135,B_10kB,10240,1.0077588558197021,10161.161016710565,918,497,421,1
136,B_10kB,10240,1.0043959617614746,10195.182368158316,1682,672,1010,1
137,B_10kB,10240,1.0028457641601562,10210.94206702423,1293,936,357,1
138,B_10kB,10240,1.003678560256958,10202.46960080366,1661,1086,575,1
139,B_10kB,10240,1.0042743682861328,10196.416759570699,2102,1203,899,1
140,B_10kB,10240,1.006572961807251,10173.13238934473,781,583,198,1
141,B_10kB,10240,1.0034852027893066,10204.43547302611,1297,756,541,1
142,B_10kB,10240,1.0052411556243896,10186.610389662754,1561,801,760,1
143,B_10kB,10240,1.0050172805786133,10188.87953260324,1293,936,357,1
144,B_10kB,10240,1.0052709579467773,10186.308396807523,931,830,101,1
145,B_10kB,10240,1.0055131912231445,10183.854462957044,995,343,652,1
146,B_10kB,10240,0.17447257041931152,58691.17406472613,1410,1159,251,1
147,B_10kB,10240,1.5121004581451416,6772.036834484641,10240,0,10240,1
148,B_10kB,10240,1.0027587413787842,10211.82820697239,10240,0,10240,1
149,B_10kB,10240,1.0026495456695557,10212.94034812719,10240,0,10240,1
150,B_10kB,10240,1.0023493766784668,10215.998770740776,10240,0,10240,1
151,B_10kB,10240,1.0027430057525635,10211.988456917563,662,457,205,1
152,B_10kB,10240,1.0057189464569092,10181.770996832603,314,294,20,1
153,B_10kB,10240,1.003126859664917,10208.080764002825,10240,0,10240,1
154,B_10kB,10240,1.0112202167510986,10126.37982347664,918,768,150,1
155,B_10kB,10240,1.004687786102295,10192.221047820509,314,294,20,1
156,B_10kB,10240,1.0067167282104492,10171.679592731847,10240,0,10240,1
157,B_10kB,10240,1.0083765983581543,10154.936178281843,1074,588,486,1
158,B_10kB,10240,1.0037944316864014,10201.291894792172,314,294,20,1
159,B_10kB,10240,1.006058692932129,10178.332608166047,10240,0,10240,1
160,B_10kB,10240,1.0152757167816162,10085.930186984471,1097,701,396,1
161,B_10kB,10240,1.0320370197296143,9922.124695374592,10240,0,10240,1
162,B_10kB,10240,1.00789213180542,10159.817382101459,983,779,204,1
163,B_10kB,10240,1.0185644626617432,10053.364686649802,1522,508,1014,1
164,B_10kB,10240,1.0294580459594727,9946.981365769154,1099,968,131,1
165,B_10kB,10240,1.0139238834381104,10099.3774456493,762,572,190,1
166,B_10kB,10240,1.0042517185211182,10196.646728252192,1702,656,1046,1
167,B_10kB,10240,1.0093016624450684,10145.62878574206,3583,2165,1418,1
168,B_10kB,10240,1.0055210590362549,10183.774778237428,1298,841,457,1
169,B_10kB,10240,1.0024917125701904,10214.548281647802,1893,1074,819,1
170,B_10kB,10240,2.518409490585327,4066.058374652974,1612,954,658,1
171,B_10kB,10240,1.0086276531219482,10152.408540758035,981,514,467,1
172,B_10kB,10240,1.0068256855010986,10170.57882755895,2256,1152,1104,1
173,B_10kB,10240,1.0041344165802002,10197.837889945615,10240,0,10240,1
174,B_10kB,10240,1.0111775398254395,10126.807209115563,1205,816,389,1
175,B_10kB,10240,1.0031108856201172,10208.24332264094,3233,1795,1438,1
176,B_10kB,10240,1.0082817077636719,10155.891871441272,2140,1244,896,1
177,B_10kB,10240,1.0088813304901123,10149.855776422615,10240,0,10240,1
178,B_10kB,10240,0.5023260116577148,20385.167724456882,10240,0,10240,1
179,B_10kB,10240,1.0069749355316162,10169.071382689339,10240,0,10240,1
180,B_10kB,10240,1.0070199966430664,10168.616347376785,10240,0,10240,1
181,B_10kB,10240,1.0032570362091064,10206.75622539636,10240,0,10240,1
182,B_10kB,10240,1.0032548904418945,10206.778055664081,10240,0,10240,1
183,B_10kB,10240,1.0034453868865967,10204.840376786009,10240,0,10240,1
184,B_10kB,10240,1.0035133361816406,10204.149392735635,851,783,68,1
185,B_10kB,10240,1.1490349769592285,8911.826189224306,2137,1023,1114,1
186,B_10kB,10240,1.0037884712219238,10201.352469743675,1225,933,292,1
187,B_10kB,10240,1.0027599334716797,10211.816067029968,2535,1216,1319,1
188,B_10kB,10240,1.0115585327148438,10122.993053617625,2076,755,1321,1
189,B_10kB,10240,1.007763147354126,10161.117745657833,901,587,314,1
190,B_10kB,10240,1.0044405460357666,10194.729832855004,1634,568,1066,1
191,B_10kB,10240,1.0028254985809326,10211.14841464473,2200,1248,952,1
192,B_10kB,10240,1.0046234130859375,10192.874132353165,670,434,236,1
193,B_10kB,10240,1.0058341026306152,10180.605303815753,2447,1011,1436,1
194,B_10kB,10240,1.0052049160003662,10186.97763710128,1379,676,703,1
195,B_10kB,10240,1.0045642852783203,10193.474076338429,756,486,270,1
196,B_10kB,10240,1.0041399002075195,10197.782199356645,2312,1249,1063,1
197,B_10kB,10240,1.0039477348327637,10199.734154194557,1832,939,893,1
198,B_10kB,10240,1.0075290203094482,10163.478960491808,464,364,100,1
199,B_10kB,10240,1.0042510032653809,10196.653990590043,2869,1306,1563,1
200,B_10kB,10240,1.0080106258392334,10158.623071532153,2040,847,1193,1
201,B_10kB,10240,2.0212628841400146,5066.139630005033,876,728,148,1
202,B_10kB,10240,1.0072996616363525,10165.793149741734,1922,879,1043,1
203,B_10kB,10240,1.0071969032287598,10166.830306143464,1681,745,936,1
204,B_10kB,10240,1.0035431385040283,10203.84635907597,549,362,187,1
205,B_10kB,10240,1.0030782222747803,10208.57573477942,1899,833,1066,1
206,B_10kB,10240,1.0066168308258057,10172.689037594708,2314,1459,855,1
207,B_10kB,10240,1.0059468746185303,10179.464003885054,3332,1813,1519,1
208,B_10kB,10240,1.0053632259368896,10185.373540450944,1550,854,696,1
209,B_10kB,10240,1.0030934810638428,10208.42044466269,2619,1445,1174,1
210,B_10kB,10240,1.0037384033203125,10201.861327739012,3571,2146,1425,1
211,B_10kB,10240,1.0073342323303223,10165.444269983002,1999,1271,728,1
212,B_10kB,10240,1.004317045211792,10195.983478345299,2751,1726,1025,1
213,B_10kB,10240,1.0111138820648193,10127.444773172985,1701,1288,413,1
214,B_10kB,10240,1.0162196159362793,10076.562033852813,2246,1258,988,1
215,B_10kB,10240,1.003021001815796,10209.15811479745,2484,1056,1428,1
216,B_10kB,10240,1.1563193798065186,8855.684838312933,822,726,96,1
217,B_10kB,10240,1.0067920684814453,10170.918425534575,2648,1628,1020,1
218,B_10kB,10240,1.007129430770874,10167.51143113962,1725,942,783,1
219,B_10kB,10240,0.5020954608917236,20394.52812780605,10240,0,10240,1
220,B_10kB,10240,1.5113685131072998,6775.316483831637,2439,1145,1294,1
221,B_10kB,10240,0.5142745971679688,19911.54153129497,314,294,20,1
222,B_10kB,10240,1.0038702487945557,10200.521444176835,10240,0,10240,1
223,B_10kB,10240,1.0056133270263672,10182.840386851305,522,454,68,1
224,B_10kB,10240,1.0052788257598877,10186.228673681264,10240,0,10240,1
225,B_10kB,10240,1.0070180892944336,10168.635607305374,10240,0,10240,1
226,B_10kB,10240,1.0078904628753662,10159.834205382553,10240,0,10240,1
227,B_10kB,10240,1.0039277076721191,10199.937626728362,10240,0,10240,1
228,B_10kB,10240,1.002429723739624,10215.179934807866,10240,0,10240,1
229,B_10kB,10240,1.0047245025634766,10191.848585232505,10240,0,10240,1
230,B_10kB,10240,1.0122551918029785,10116.026159135843,10240,0,10240,1
231,B_10kB,10240,1.0030064582824707,10209.306146976145,10240,0,10240,1
232,B_10kB,10240,1.1335313320159912,9033.715884842908,2364,1198,1166,1
233,B_10kB,10240,1.0058765411376953,10180.175778250145,1814,802,1012,1
234,B_10kB,10240,1.0037622451782227,10201.6190080768,10240,0,10240,1
235,B_10kB,10240,1.0023400783538818,10216.093540644306,1640,499,1141,1
236,B_10kB,10240,1.0051167011260986,10187.871705372572,2207,1117,1090,1
237,B_10kB,10240,1.0066382884979248,10172.472194833575,1090,597,493,1
238,B_10kB,10240,1.002392292022705,10215.561393969752,2048,1157,891,1
239,B_10kB,10240,1.003627061843872,10202.993112986596,1598,618,980,1
240,B_10kB,10240,1.007897138595581,10159.766912592459,970,567,403,1
241,B_10kB,10240,1.008427619934082,10154.422387468283,1740,877,863,1
242,B_10kB,10240,1.023425817489624,10005.610396968335,2035,926,1109,1
243,B_10kB,10240,1.0114436149597168,10124.143203383446,1195,801,394,1
244,B_10kB,10240,1.0168101787567139,10070.709571889587,1728,488,1240,1
245,B_10kB,10240,1.0038044452667236,10201.190130493098,1595,1070,525,1
246,B_10kB,10240,1.0032312870025635,10207.018194772303,1069,762,307,1
247,B_10kB,10240,1.0030624866485596,10208.735882660681,1352,262,1090,1
248,B_10kB,10240,2.005495071411133,5105.971161921029,1669,768,901,1
249,B_10kB,10240,1.0027997493743896,10211.410609534321,1098,787,311,1
250,B_10kB,10240,1.0028493404388428,10210.905653603977,1223,719,504,1
251,B_10kB,10240,1.003119945526123,10208.151124568913,1490,522,968,1
252,B_10kB,10240,1.0035121440887451,10204.161514456402,1540,1010,530,1
253,B_10kB,10240,1.0027313232421875,10212.107433614852,1668,992,676,1
254,B_10kB,10240,1.0079874992370605,10158.856144298012,1635,862,773,1
255,B_10kB,10240,1.0109682083129883,10128.904070176035,1519,589,930,1
256,B_10kB,10240,1.0132884979248047,10105.710289785507,988,643,345,1
257,B_10kB,10240,1.0194008350372314,10045.11635467319,1728,1084,644,1
258,B_10kB,10240,1.0186378955841064,10052.63994633558,1851,942,909,1
259,B_10kB,10240,0.5075628757476807,20174.840377984034,10240,0,10240,1
260,B_10kB,10240,1.0049374103546143,10189.689322429136,10240,0,10240,1
261,B_10kB,10240,1.008756160736084,10151.11520362654,10240,0,10240,1
262,B_10kB,10240,1.0088846683502197,10149.822195975063,10240,0,10240,1
263,B_10kB,10240,1.142423152923584,8963.403773632157,1883,1142,741,1
264,B_10kB,10240,1.0169322490692139,10069.500706042661,10240,0,10240,1
265,B_10kB,10240,1.0115082263946533,10123.496510254508,1113,883,230,1
266,B_10kB,10240,1.011430263519287,10124.276847688701,1874,942,932,1
267,B_10kB,10240,1.0082600116729736,10156.110409465804,1421,1098,323,1
268,B_10kB,10240,1.0088553428649902,10150.11723179263,637,536,101,1
269,B_10kB,10240,1.016331434249878,10075.453395336355,1911,727,1184,1
270,B_10kB,10240,1.0179417133331299,10059.515064443454,1004,646,358,1
271,B_10kB,10240,1.015073537826538,10087.93906885382,783,339,444,1
272,B_10kB,10240,1.0074379444122314,10164.397774370424,1814,1084,730,1
273,B_10kB,10240,1.0037202835083008,10202.045498381438,1152,549,603,1
274,B_10kB,10240,1.004051685333252,10198.678165259262,1141,640,501,1
275,B_10kB,10240,1.0170152187347412,10068.679220690015,1752,968,784,1
276,B_10kB,10240,1.007267951965332,10166.113177749985,1370,813,557,1
277,B_10kB,10240,1.01416015625,10097.024554646125,816,614,202,1
278,B_10kB,10240,1.0103051662445068,10135.551457253252,2086,1102,984,1
279,B_10kB,10240,2.0096819400787354,5095.333642496094,1402,1021,381,1
280,B_10kB,10240,1.0031664371490479,10207.678029083192,1434,1086,348,1
281,B_10kB,10240,1.003488540649414,10204.401530458053,1829,1296,533,1
282,B_10kB,10240,1.0057287216186523,10181.672035297364,1434,965,469,1
283,B_10kB,10240,1.0035593509674072,10203.681516323757,1038,743,295,1
284,B_10kB,10240,1.003544807434082,10203.829389723205,2651,1311,1340,1
285,B_10kB,10240,1.003751516342163,10201.728050500245,1247,683,564,1
286,B_10kB,10240,1.0043132305145264,10196.022205894746,1254,659,595,1
287,B_10kB,10240,1.0032224655151367,10207.107946632697,1698,775,923,1
288,B_10kB,10240,1.0037031173706055,10202.219981966044,1373,883,490,1
289,B_10kB,10240,1.0030152797698975,10209.216356453879,1217,968,249,1
290,B_10kB,10240,1.0034582614898682,10204.709446306544,2156,1104,1052,1
291,B_10kB,10240,1.0040111541748047,10199.089878056426,814,710,104,1
292,B_10kB,10240,1.0034267902374268,10205.029504521255,934,350,584,1
293,B_10kB,10240,1.0053176879882812,10185.8349080588,1893,803,1090,1
294,B_10kB,10240,0.13220906257629395,77453.08680402146,1174,606,568,1
295,B_10kB,10240,1.504941701889038,6804.250282350813,1162,1036,126,1
296,B_10kB,10240,1.003434181213379,10204.954337530662,663,643,20,1
297,B_10kB,10240,1.0026178359985352,10213.26335153583,1405,926,479,1
298,B_10kB,10240,1.003833293914795,10200.896963743433,2530,1201,1329,1
299,B_10kB,10240,1.003380537033081,10205.49992954706,1135,534,601,1
300,B_10kB,10240,1.0038173198699951,10201.0592936633,1214,758,456,1
301,B_10kB,10240,1.0034358501434326,10204.937364492487,1046,654,392,1
302,B_10kB,10240,1.0046987533569336,10192.109789910422,314,294,20,1
303,B_10kB,10240,1.0063588619232178,10175.296693299533,10240,0,10240,1
304,B_10kB,10240,1.010554552078247,10133.050194015768,879,665,214,1
305,B_10kB,10240,1.00697660446167,10169.054528803386,314,294,20,1
306,B_10kB,10240,1.0022320747375488,10217.19445836087,10240,0,10240,1
307,B_10kB,10240,1.0057542324066162,10181.413778888353,912,379,533,1
308,B_10kB,10240,1.0037503242492676,10201.740166468964,2155,1145,1010,1
309,B_10kB,10240,1.007051944732666,10168.29375441833,1007,655,352,1
310,B_10kB,10240,1.1323871612548828,9042.843605408147,2282,1485,797,1
311,B_10kB,10240,1.0032389163970947,10206.94057281454,1876,911,965,1
312,B_10kB,10240,1.0058491230010986,10180.453276578355,1108,798,310,1
313,B_10kB,10240,1.009171724319458,10146.935108497431,1701,1340,361,1
314,B_10kB,10240,1.0069248676300049,10169.577025247025,1920,1114,806,1
315,B_10kB,10240,1.0225770473480225,10013.915358805167,808,695,113,1
316,B_10kB,10240,1.006566047668457,10173.202268961146,2673,1633,1040,1
317,B_10kB,10240,1.0028386116027832,10211.014894643871,1511,700,811,1
318,B_10kB,10240,1.013397216796875,10104.626133044238,1229,663,566,1
319,B_10kB,10240,1.0031187534332275,10208.163255799029,1452,927,525,1
320,B_10kB,10240,1.0030999183654785,10208.354933061679,1713,668,1045,1
321,B_10kB,10240,1.0043118000030518,10196.036728801637,1906,1261,645,1
322,B_10kB,10240,1.0026185512542725,10213.256065519428,1555,670,885,1
323,B_10kB,10240,1.00762939453125,10162.466533406021,1529,789,740,1
324,B_10kB,10240,1.0087404251098633,10151.273553733854,1716,1488,228,1
325,B_10kB,10240,1.0033295154571533,10206.018902308764,2248,1135,1113,1
326,B_10kB,10240,2.0115480422973633,5090.606729086633,1321,771,550,1
327,B_10kB,10240,1.0028555393218994,10210.842537624092,916,696,220,1
328,B_10kB,10240,1.0036420822143555,10202.840416383582,795,385,410,1
329,B_10kB,10240,1.0035429000854492,10203.848783273828,1637,705,932,1
330,B_10kB,10240,1.007035732269287,10168.457455749709,1106,787,319,1
331,B_10kB,10240,1.0058226585388184,10180.721137139506,784,636,148,1
332,B_10kB,10240,1.007148265838623,10167.321284591053,1780,818,962,1
333,B_10kB,10240,1.0034291744232178,10205.005256983948,1059,861,198,1
